冥龙锁天阵=Minh Long Tỏa Thiên Trận
明月山水图=Minh Nguyệt Sơn Thủy Đồ
狱山大荒泽=Ngục Sơn Đại Hoang Trạch
赤明九天图=Xích Minh Cửu Thiên Đồ
万象真人=Vạn Tượng Chân Nhân
东林山脉=Đông Lâm sơn mạch
仙缘大会=Tiên Duyên Đại Hội
元神道人=Nguyên Thần Đạo Nhân
北山黑虎=Bắc Sơn Hắc Hổ
夏芒紫山=Hạ Mang Tử Sơn
大夏世界=Đại Hạ thế giới
大夏王朝=Đại Hạ vương triều
大夏王都=Đại Hạ vương đô
封禁大阵=Phong Cấm Đại Trận
小千剑阵=Tiểu Thiên Kiếm Trận
少炎公子=Thiếu Viêm công tử
惜月郡主=Tích Nguyệt quận chúa
木传真人=Mộc Truyền Chân Nhân
殿才仙人=Điện Tài Tiên Nhân
水火莲花=Thủy Hỏa Liên Hoa
沧江真人=Thương Giang Chân Nhân
浮云仙人=Phù Vân Tiên Nhân
火翼妖王=Hỏa Dực Yêu Vương
玄机老祖=Huyền Cơ Lão Tổ
白鹤漩涡=Vòng Xoáy Bạch Hạc
紫府修士=Tử Phủ Tu Sĩ
纪宁公子=Kỷ Ninh công tử
纯阳真仙=Thuần Dương Chân Tiên
许离真人=Hứa Ly Chân Nhân
赤明九天=Xích Minh Cửu Thiên
道之域境=Đạo Chi Vực Cảnh
邋遢真人=Lạp Tháp Chân Nhân
雎华仙人=Sư Hoa Tiên Nhân
雪羽道人=Tuyết Vũ Đạo Nhân
风翼遁法=Phong Dực Độn Pháp
黄毛大熊=hoàng mao đại hùng
黑白学宫=Hắc Bạch Học Cung
黑石真人=Hắc Thạch Chân Nhân
龙鲸大妖=Long Kình Đại Yêu
三尺剑=Tam Xích Kiếm
伍文定=Ngũ Văn Định
传送使=Truyện Tống Sử
剑齿虎=Kiếm Xỉ Hổ
北冥剑=Bắc Minh kiếm
北山氏=Bắc Sơn thị
北山狐=Bắc Sơn Hồ
大荒泽=Đại Hoang Trạch
大雪山=Đại Tuyết sơn
天仙的=Thiên Tiên
天宝山=Thiên Bảo Sơn
安澶侯=An Thiền Hầu
安澶郡=An Thiền quận
尉迟雪=Uất Trì Tuyết
少炎农=Thiếu Viêm Nông
少炎氏=Thiếu Viêm thị
应龙卫=Ứng Long Vệ
摘星手=Trích Tinh Thủ
方寸山=Phương Thốn Sơn
无间门=Vô Gian Môn
明月山=Minh Nguyệt Sơn
木子朔=Mộc Tử Sóc
洞子启=Động Tử Khải
白水泽=Bạch Thủy Trạch
相柳方=Tương Liễu Phương
空青蛇=Không Thanh Xà
纪九火=Kỷ Cửu Hỏa
纪留真=Kỷ Lưu Chân
维塔斯=Vitas
翼蛇湖=Dực Xà Hồ
苍梧鹫=Thương Ngô Thứu
血云楼=Huyết Vân Lâu
血神教=Huyết Thần Giáo
论道殿=Luận Đạo Điện
铁木占=Thiết Mộc Chiêm
雪龙山=Tuyết Long Sơn
万象=Vạn Tượng
三寿=Tam Thọ
九莲=Cửu Liên
元神=Nguyên Thần
先天=Tiên Thiên
唐天=Đường Thiên
夏芒=Hạ Mang
大夏=Đại Hạ
天仙=Thiên Tiên
子朔=Tử Sóc
安澶=An Thiền
少炎=Thiếu Viêm
巫江=Vu Giang
应龙=Ứng Long
延王=Duyên Vương
木传=Mộc Truyền
殿才=Điện Tài
沧江=Thương Giang
燕山=Yến Sơn
百微=Bách Vi
神魔=Thần Ma
秋叶=Thu Diệp
穷奇=Cùng Kỳ
紫府=Tử Phủ
纪宁=Kỷ Ninh
纪氏=Kỷ thị
翼蛇=Dực Xà
许离=Hứa Ly
道祖=Đạo Tổ
邋遢=Lạp Tháp
雎华=Sư Hoa
雪龙=Tuyết Long
顾雪=Cố Tuyết
风翼=Phong Dực
鬼爪=Quỷ Trảo
兵=Binh
